8 15 0 11
##########  ###
##  ### #  ####
####   ###   ##
###  ## ## # ##
### ### #### ##
##   ####  # ##
####   ## ## ##
####   o     ##