10 18 0 11
#                #
### ##############
# # #####        #
#         # # #  #
######### # # #  #
#    ####  #   # #
# ##      ###   ##
#  #     ####### #
# #o####         #
#       ######o###
